11111111111111111111
10000000000000000001
10000000000000000001
10000000000000000001
10000000000000000001
10000000000007000001
10000000000000000001
10000000000000000001
10000000070000000001
10000000000000000006
10000000000000000001
10000000000000000001
10000400000000000001
10400050000000000001
10000000000000000001
10000400000000000001
10400050000000000001
10000000000000000001
10000400000000000001
11111111111111111111
11111111111111111111
10000000000000000001
10000000000000000001
10000000000000000001
10000000000000000001
10000000000007000001
10000000000000000001
10000000000000000001
10000000070000000001
10000000000000000006
10000000000000000001
10000000000000000001
10000400000000000001
10400050000000000001
10000000000000000001
10000400000000000001
10400050000000000001
10000000000000000001
10000400000000000001
11111111111111111111
11111111111111111111
10000000000000000001
10000000000000000001
10000000000000000001
10000000000000000001
10000000000007000001
10000000000000000001
10000000000000000001
10000000070000000001
10000000000000000006
10000000000000000001
10000000000000000001
10000400000000000001
10400050000000000001
10000000000000000001
10000400000000000001
10400050000000000001
10000000000000000001
10000400000000000001
11111111111111111111